-1 -1 -1 -1 -1 -1 -1 -1 -1 -1 -1 -1 -1 -1 -1 -1 -1 -1 -1 -1 -1 -1 -1 -1 -1 -1 -1 -1 -1 -1 -1 -1 -1 -1 -1 -1 -1 -1 -1 -1 -1 -1 -1 -1 -1 -1 -1 -1 -1 -1 -1 -1 -1 -1 -1 -1 -1 -1 -1 -1
-1 -1 -1 -1 -1 -1 -1 -1 -1 -1 -1 -1 -1 -1 -1 -1 -1 -1 -1 -1 -1 -1 -1 -1 -1 -1 -1 -1 -1 -1 -1 -1 -1 -1 -1 -1 -1 -1 -1 -1 -1 -1 -1 -1 -1 -1 -1 -1 -1 -1 -1 -1 -1 -1 -1 -1 -1 -1 -1 -1
-1 -1 -1 -1 -1 -1 -1 -1 -1 -1 -1 -1 -1 -1 -1 -1 -1 -1 -1 -1 -1 -1 -1 -1 -1 -1 -1 -1 -1 -1 -1 -1 -1 -1 -1 -1 -1 -1 -1 -1 -1 -1 -1 -1 -1 -1 -1 -1 -1 -1 -1 -1 -1 -1 -1 -1 -1 -1 -1 -1
-1 -1 -1 -1 -1 -1 -1 -1 -1 -1 -1 -1 -1 -1 -1 -1 -1 -1 -1 -1 -1 -1 -1 -1 -1 -1 -1 -1 -1 -1 -1 -1 -1 -1 -1 -1 -1 -1 -1 -1 -1 -1 -1 -1 -1 -1 -1 -1 -1 -1 -1 -1 -1 -1 -1 -1 -1 -1 -1 -1
-1 -1 -1 -1 -1 -1 -1 -1 -1 -1 -1 -1 -1 -1 -1 -1 -1 -1 -1 -1 -1 -1 -1 -1 -1 -1 -1 -1 -1 -1 -1 -1 -1 -1 -1 -1 -1 -1 -1 -1 -1 -1 -1 -1 -1 -1 -1 -1 -1 -1 -1 -1 -1 -1 -1 -1 -1 -1 -1 -1
-1 -1 -1 -1 -1 -1 -1 -1 -1 -1 -1 -1 -1 -1 -1 -1 -1 -1 -1 -1 -1 -1 -1 -1 -1 -1 -1 -1 -1 -1 -1 -1 -1 -1 -1 -1 -1 -1 -1 -1 -1 -1 -1 -1 -1 -1 -1 -1 -1 -1 -1 -1 -1 -1 -1 -1 -1 -1 -1 -1
-1 -1 -1 -1 -1 -1 -1 -1 -1 -1 -1 -1 -1 -1 -1 -1 -1 -1 -1 -1 -1 -1 -1 -1 -1 -1 -1 -1 -1 -1 -1 -1 -1 -1 -1 -1 -1 -1 -1 -1 -1 -1 -1 -1 -1 -1 -1 -1 -1 -1 -1 -1 -1 -1 -1 -1 -1 -1 -1 -1
-1 -1 -1 -1 -1 -1 -1 -1 -1 -1 -1 -1 -1 -1 -1 -1 -1 -1 -1 -1 -1 -1 -1 -1 -1 -1 -1 -1 -1 -1 -1 -1 -1 -1 -1 -1 -1 -1 -1 -1 -1 -1 -1 -1 -1 -1 -1 -1 -1 -1 -1 -1 -1 -1 -1 -1 -1 -1 -1 -1
-1 -1 -1 -1 -1 -1 -1 -1 -1 -1 -1 -1 -1 -1 -1 -1 -1 -1 -1 -1 -1 -1 -1 -1 -1 -1 -1 -1 -1 -1 -1 -1 -1 -1 -1 -1 -1 -1 -1 -1 -1 -1 -1 -1 -1 -1 -1 -1 -1 -1 -1 -1 -1 -1 -1 -1 -1 -1 -1 -1
-1 -1 -1 -1 -1 -1 -1 -1 -1 -1 -1 -1 -1 -1 -1 -1 -1 -1 -1 -1 -1 -1 -1 -1 -1 -1 -1 -1 -1 -1 -1 -1 -1 -1 -1 -1 -1 -1 -1 -1 -1 -1 -1 -1 -1 -1 -1 -1 -1 -1 -1 -1 -1 -1 -1 -1 -1 -1 -1 -1
-1 -1 -1 -1 -1 -1 -1 -1 -1 -1 -1 -1 -1 -1 -1 -1 -1 -1 -1 -1 -1 -1 -1 -1 -1 -1 -1 -1 -1 -1 -1 -1 -1 -1 -1 -1 -1 -1 -1 -1 -1 -1 -1 -1 -1 -1 -1 -1 -1 -1 -1 -1 -1 -1 -1 -1 -1 -1 -1 -1
-1 -1 -1 -1 -1 -1 -1 -1 -1 -1 -1 -1 -1 -1 -1 -1 -1 -1 -1 -1 -1 -1 -1 -1 -1 -1 -1 -1 -1 -1 -1 -1 -1 -1 -1 -1 -1 -1 -1 -1 -1 -1 -1 -1 -1 -1 -1 -1 -1 -1 -1 -1 -1 -1 -1 -1 -1 -1 -1 -1
-1 -1 -1 -1 -1 -1 -1 -1 -1 -1 -1 -1 -1 -1 -1 -1 -1 -1 -1 -1 -1 -1 -1 -1 -1 -1 -1 -1 -1 -1 -1 -1 -1 -1 -1 -1 -1 -1 -1 -1 -1 -1 -1 -1 -1 -1 -1 -1 -1 -1 -1 -1 -1 -1 -1 -1 -1 -1 -1 -1
-1 -1 -1 -1 -1 -1 -1 -1 -1 -1 -1 -1 -1 -1 -1 -1 -1 -1 -1 -1 -1 -1 -1 -1 -1 -1 -1 -1 -1 -1 -1 -1 -1 -1 -1 -1 -1 -1 -1 -1 -1 -1 -1 -1 -1 -1 -1 -1 -1 -1 -1 -1 -1 -1 -1 -1 -1 -1 -1 -1
-1 -1 -1 -1 -1 -1 -1 -1 -1 -1 -1 -1 -1 -1 -1 -1 -1 -1 -1 -1 -1 -1 -1 -1 -1 -1 -1 -1 -1 -1 -1 -1 -1 -1 -1 -1 -1 -1 -1 -1 -1 -1 -1 -1 -1 -1 -1 -1 -1 -1 -1 -1 -1 -1 -1 -1 -1 -1 -1 -1
-1 -1 -1 -1 -1 -1 -1 -1 -1 -1 -1 -1 -1 -1 -1 -1 -1 -1 -1 -1 -1 -1 -1 -1 -1 -1 -1 -1 -1 -1 -1 -1 -1 -1 111 112 113 114 115 116 117 118 119 120 112 113 114 115 116 117 118 119 120 121 -1 -1 -1 -1 -1 -1
-1 -1 -1 -1 -1 -1 -1 -1 -1 -1 -1 -1 -1 -1 -1 -1 -1 -1 -1 -1 -1 -1 -1 -1 -1 -1 -1 -1 -1 -1 -1 -1 -1 -1 -1 -1 439 440 441 -1 -1 -1 -1 -1 -1 -1 -1 -1 -1 439 440 441 -1 -1 -1 -1 -1 -1 -1 -1
-1 -1 -1 -1 -1 -1 -1 -1 -1 -1 -1 -1 -1 -1 -1 -1 -1 -1 -1 -1 -1 -1 -1 -1 -1 -1 -1 -1 -1 -1 -1 -1 -1 -1 -1 -1 503 504 505 -1 -1 -1 -1 -1 -1 -1 -1 -1 -1 503 504 505 -1 -1 -1 -1 -1 -1 -1 -1
-1 -1 -1 -1 -1 -1 -1 -1 -1 -1 -1 -1 -1 -1 -1 -1 -1 -1 -1 -1 -1 -1 -1 -1 -1 -1 -1 -1 -1 -1 -1 -1 -1 -1 -1 -1 567 568 569 -1 -1 -1 -1 -1 -1 -1 -1 -1 -1 567 568 569 -1 -1 -1 -1 -1 -1 -1 -1
-1 -1 -1 -1 -1 -1 -1 -1 -1 -1 -1 -1 -1 -1 -1 -1 -1 -1 -1 -1 111 112 113 114 115 116 117 118 119 120 121 -1 -1 -1 -1 -1 439 440 441 -1 -1 -1 -1 -1 -1 -1 -1 -1 -1 439 440 441 -1 -1 -1 -1 -1 -1 -1 -1
-1 -1 -1 -1 -1 -1 -1 -1 -1 -1 -1 -1 -1 -1 -1 -1 -1 -1 -1 -1 -1 439 440 441 -1 -1 -1 439 440 441 -1 -1 -1 -1 -1 -1 503 504 505 -1 -1 -1 -1 -1 -1 -1 -1 -1 -1 503 504 505 -1 -1 -1 -1 -1 -1 -1 -1
111 112 113 114 115 116 117 118 119 120 121 -1 -1 -1 -1 -1 -1 -1 -1 -1 -1 503 504 505 -1 -1 -1 503 504 505 -1 -1 -1 -1 -1 -1 567 568 569 -1 -1 -1 -1 -1 -1 -1 -1 -1 -1 567 568 569 -1 -1 -1 -1 -1 -1 -1 -1
-1 439 440 441 -1 -1 -1 439 440 441 -1 -1 -1 -1 -1 -1 -1 -1 -1 -1 -1 567 568 569 -1 -1 -1 567 568 569 -1 -1 -1 -1 -1 -1 439 440 441 -1 -1 -1 -1 -1 -1 -1 -1 -1 -1 439 440 441 -1 -1 -1 -1 -1 -1 -1 -1
-1 503 504 505 -1 -1 -1 503 504 505 -1 -1 -1 -1 -1 -1 -1 -1 -1 -1 -1 439 440 441 -1 -1 -1 439 440 441 -1 -1 -1 -1 -1 -1 503 504 505 -1 -1 -1 -1 -1 -1 -1 -1 -1 -1 503 504 505 -1 -1 -1 -1 -1 -1 -1 -1
-1 567 568 569 -1 -1 -1 567 568 569 -1 -1 -1 -1 -1 -1 -1 -1 -1 -1 -1 503 504 505 -1 -1 -1 503 504 505 -1 -1 -1 -1 -1 -1 567 568 569 -1 -1 -1 -1 -1 -1 -1 -1 -1 -1 567 568 569 -1 -1 -1 -1 -1 -1 -1 -1
-1 439 440 441 -1 -1 -1 439 440 441 -1 -1 -1 -1 -1 -1 -1 -1 -1 -1 -1 567 568 569 -1 -1 -1 567 568 569 -1 -1 -1 -1 -1 -1 439 440 441 -1 -1 -1 -1 -1 -1 -1 -1 -1 -1 439 440 441 -1 -1 -1 -1 -1 -1 -1 -1
-1 503 504 505 -1 -1 -1 503 504 505 -1 -1 -1 -1 -1 -1 -1 -1 -1 -1 -1 439 440 441 -1 -1 -1 439 440 441 -1 -1 -1 -1 -1 -1 503 504 505 -1 -1 -1 -1 -1 -1 -1 -1 -1 -1 503 504 505 -1 -1 -1 -1 -1 -1 -1 -1
-1 567 568 569 -1 -1 -1 567 568 569 -1 -1 -1 -1 -1 -1 -1 -1 -1 -1 -1 503 504 505 -1 -1 -1 503 504 505 -1 -1 -1 -1 -1 -1 567 568 569 -1 -1 -1 -1 -1 -1 -1 -1 -1 -1 567 568 569 -1 -1 -1 -1 -1 -1 -1 -1
-1 439 440 441 -1 -1 -1 439 440 441 -1 -1 -1 -1 -1 -1 -1 -1 -1 -1 -1 567 568 569 -1 -1 -1 567 568 569 -1 -1 -1 -1 -1 -1 439 440 441 -1 -1 -1 -1 -1 -1 -1 -1 -1 -1 439 440 441 -1 -1 -1 -1 -1 -1 -1 -1
-1 503 504 505 -1 -1 -1 503 504 505 -1 -1 -1 -1 -1 -1 -1 -1 -1 -1 -1 439 440 441 -1 -1 -1 439 440 441 -1 -1 -1 -1 -1 -1 503 504 505 -1 -1 -1 -1 -1 -1 -1 -1 -1 -1 503 504 505 -1 -1 -1 -1 -1 -1 -1 -1